+---------------------------------------------------------+
| ~~~~~~~~~~~~~~~~~~~~~~~~~~~~~~~~~~~~~~~~~~~~~~~~~~~~~~~ |
|   ~~~~~~~~~~~~~~~~~~~~~~~~~~~~~~~~~~~~~~~~~~~~~~~~~~~   |
|   ( ~~~~~~~~~~~~~~~~~~~~~~~~~~~~~~~~~~~~~~~~~~~~~~~     |
|  ()   &~~~~~~~~~~~~~~~~~~~~~~~~~~~~~~~~~~~~~~~~~&   )   |
|  )#)  && |      |      |      |      |      |  &&  ( )( |
| ()##( &&---------------------------------------&&  )#(  |
|  )### &&     |      |      |      |      |     &&  ###) |
| (###  &&---------------------------------------&& ##### |
|--/ /# && |      |      /----------\  |      |  &&  \ \--|
|-/ /   &&---------------|          |------------&&   \ \-|
|/ /    &&     |      |  |          |      |     &&    \ \|
| /     &&---------------|          |------------&&     \ |
|/      && |      |      |          |  |      |  &&      \|
|       &&---------------|          |------------&&       |
|       &&     |      |  |          |      |     &&       |
|       &*****************************************&       |
|      *********************************************      |
|    *************************************************    |
|  *****************************************************  |
|*********************************************************|
+---------------------------------------------------------+