+---------------------------------------------------------+
| ~~~~~~~~~~~~~~~~~~~~~~~~~~~~~~~~~~~~~~~~~~~~~~~~~~~~~~~ |
|   ~~~~~~~~~~~~~~~~~~~~~~~~~~~~~~~~~~~~~~~~~~~~~~~~~~~   |
|   ( ~~~~~~~~~~~~~~~~~~~~~~~~~~~~~~~~~~~~~~~~~~~~~~~     |
|  ()   &~~~~~~~~~~~~~~~~~~~~~~~~~~~~~~~~~~~~~~~~~&   )   |
|  )#)  && |      |      |      |      |      |  &&  ( )( |
| ()##( &&---------------------------------------&&  )#(  |
|  )### &&     |      |      |      |      |     &&  ###) |
| (###  &&---------------------------------------&& ##### |
|--/ /# && |      |      |      |      |      |  &&  \ \--|
|-/ /   &&---------------------------------------&&   \ \-|
|/ /    &&     |      |      |      |      |     &&    \ \|
| /     &&---------------------------------------&&     \ |
|/      && |      |      |      |      |      |  &&      \|
|       &&---------------------------------------&&       |
|       &&     |      |      |      |      |     &&       |
|       &*****************************************&       |
|      *********************************************      |
|    *************************************************    |
|  *****************************************************  |
|*********************************************************|
+---------------------------------------------------------+